##########
#....#...#
#@.#.....#
#######..#
#.....#..#
#.#####..#
#.#####..#
#.#####..#
#........#
##########