##########
#@.......#
########.#
#........#
#.########
#........#
########.#
########.#
#........#
##########